R -400 400
NO ./textures/purplestone.xpm
SO ./textures/bluestone.xpm
WE ./textures/colorstone.xpm
EA ./textures/eagle.xpm
S ./textures/barrel.xpm
F 33,100,0
C 225,30,44
1111111111
1000000001
1000000001
100000N001
1111111111