WE ./textures/colorstone.xpm

R         1020               510
NO ./textures/purplestone.xpm




S ./textures/barrel.xpm
C 0,200,    0
SO      ./textures/bluestone.xpm

EA ./textures/eagle.xpm
F      0,    0, 100



1111111111
1        1
1000000001
11111N1111