R 1020 510
NO ./textures/purplestone.xpm
SO ./textures/bluestone.xpm
WE ./textures/colorstone.xpm
EA ./textures/eagle.xpm
S ./textures/barrel.xpm
F 110,100,100
C 30,30,30
1111111111
1000002001
1000000001
100000N001
1111111111