R1020 510
NO./textures/purplestone.xpm
SO./textures/bluestone.xpm
WE./textures/colorstone.xpm
EA./textures/eagle.xpm
S./textures/barrel.xpm
F0,0,0
C0,0,0
1111111111
1222222221
1222222221
100000N001
1111111111