R 1280 960
NO ./textures/purplestone.xpm
SO ./textures/bluestone.xpm
WE ./textures/colorstone.xpm
EA ./textures/eagle.xpm
S ./textures/barrel.xpm
F 220,100,0
C 225,30,0
111111111111111111111111
100000000000000000000001
100200000000000000002001
100000000000000000000001
100000111110000101010001
100000100010000000000001
100000100010000100010001
100000100010000000000001
100000110110000101010001
100000000000000000000001
100000000000000000002001
100000000000000000000001
100000000000000000000001
100000000000000000000001
100200000000000000000001
100000000000000000000001
111111111000000000000001
110100001000000000000001
110000101000000000000001
110100001000000N00000021
110111111000000000000201
110000000000000000002001
111111111000000000020001
111111111111111111111111