R 960 960
NO ./textures/purplestone.xpm
SO ./textures/bluestone.xpm
WE ./textures/colorstone.xpm
EA ./textures/eagle.xpm
S ./textures/barrel.xpm
F 220,100,0
C 225,30,0
111111111111111
100000000000001
100000000002001
10E000000002101
100000000002001
100000000000001
111111111111111