R 1280 960
NO ./textures/purplestone.xpm
SO ./textures/bluestone.xpm
WE ./textures/colorstone.xpm
EA ./textures/eagle.xpm
S ./textures/barrel.xpm
F 220,220,220
C 225,30,0

        1111111111111111111111111
        1000000111100001110000001
        1011000111100001112000001
        1001000111000001110000001
        1111111111100001111100001
        1000000111100001111101111
        1111011111100001110000001
        1111011111100001110101001
        1100000111000001110000001
        1000200000000000000000001
        1000000111000001110101001
        1100000111000001111101111
        1111011111100001110111101
        1111011111100001110111101
        1111011111100001110111101
        1111011111100001110111101
        1111011111100001110111101
        1111011111100001110111101
        1111011111100001110111101
        1111011111100001110111101
        1100000111000001110000001
        1000200000000000000000001
        1000000111000001110101001
        1100000111000001111101111
        1111011111100001110111101
        1111011111100001110111101
        1111011111100001110111101
        1111011111100001110111101
        1111011111100001110111101
        1111011111100001110111101
        1111011111100001110111101
        1111011111100001110111101
        1111011111100001110111101
        1111011111100001110111101
        1111011111100001110111101
        1111011111100001110111101
        1111011111100001110111101
        1111011111100001110111101
        1111011111100001110111101
        1111011111100001110111101
        1111011111100001110111101
        1111011111100001110111101
        1111011111100001110111101
        1111011111100001110111101
        1111011111100001110111101
        1111011111100001110111101
        1111011111100001110111101
        1111011111100001110111101
        1111011111100001110111101
        1100000111000001110000001
        1000200000000000000000001
        1000000111000001110101001
        1100000111000001111101111
        1111011111100001110111101
        1111011111100001110111101
        1111011111100001110111101
        1111011111100001110111101
        1111011111100001110111101
        1111011111100001110111101
        1111011111100001110111101
        1111011111100001110111101
        1100000111000001110000001
        1000200000000000000000001
        1000000111000001110101001
        1100000111000001111101111
        1111011111100001110111101
        1111011111100001110111101
        1111011111100001110111101
        1111011111100001110111101
        1111011111100001110111101
        1111011111100001110111101
        1111011111100001110111101
        1111011111100001110111101
        1100000111000001110000001
        1000200000000000000000001
        1000000111000001110101001
        1100000111000001111101111
        1111011111100001110111101
        1111011111100001110111101
        1111011111100001110111101
        1111011111100001110111101
        1111011111100001110111101
        1111011111100001110111101
        1111011111100001110111101
        1111011111100001110111101
        1100000111000001110000001
        1000200000000000000000001
        1000000111000001110101001
        1100000111000001111101111
        1111011111100001110111101
        1111011111100001110111101
        1111011111100001110111101
        1111011111100001110111101
        1111011111100001110111101
        1111011111100001110111101
        1111011111100001110111101
        1111011111100001110111101
        1100000111000001110000001
        1000200000000000000000001
        1000000111000001110101001
        1100000111000001111101111
        1111011111100001110111101
        1111011111100001110111101
        1111011111100001110111101
        1111011111100001110111101
        1111011111100001110111101
        1111011111100001110111101
        1111011111100001110111101
        1111011111100001110111101
        1100000111000001110000001
        1000200000000000000000001
        1000000111000001110101001
        1100000111000001111101111
        1111011111100001110111101
        1111011111100001110111101
        1111011111100001110111101
        1111011111100001110111101
        1111011111100001110111101
        1111011111100001110111101
        1111011111100001110111101
        1111011111100001110111101
        1111011111100001110111101
        1111011111100001110111101
        1111011111100001110111101
        1111011111100001110111101
        1111011111100001110111101
        1111011111100001110111101
        1111011111100001110111101
        1111011111100001110111101
        1111011111100001110111101
        1111011111100001110111101
        1111011111100001110111101
        1111011111100001110111101
        1111011111100001110111101
        1111011111100001110111101
        1111011111100001110111101
        1111011111100001110111101
        1111011111100001110111101
        1111011111100N01110111101
        1111011111100001110111101
        1111111111111111111111111